,Level,Name,TRU,TOT_P,TOT_M,TOT_F
0,India,India,Total,1210854977,623270258,587584719
3,STATE,JK,Total,12541302,6640662,5900640
6,DISTRICT,JK_Kupwara,Total,870354,474190,396164
9,DISTRICT,JK_Budgam,Total,753745,398041,355704
12,DISTRICT,LA_Leh,Total,133487,78971,54516
19,STATE,LA,Total,274289,156756,117533
15,DISTRICT,LA_Kargil,Total,140802,77785,63017
18,DISTRICT,JK_Punch,Total,476835,251899,224936
21,DISTRICT,JK_Rajouri,Total,642415,345351,297064
24,DISTRICT,JK_Kathua,Total,616435,326109,290326
27,DISTRICT,JK_Baramulla,Total,1008039,534733,473306
30,DISTRICT,JK_Bandipora,Total,392232,207680,184552
33,DISTRICT,JK_Srinagar,Total,1236829,651124,585705
36,DISTRICT,JK_Ganderbal,Total,297446,158720,138726
39,DISTRICT,JK_Pulwama,Total,560440,293064,267376
42,DISTRICT,JK_Shopiyan,Total,266215,136480,129735
45,DISTRICT,JK_Anantnag,Total,1078692,559767,518925
48,DISTRICT,JK_Kulgam,Total,424483,217620,206863
51,DISTRICT,JK_Doda,Total,409936,213641,196295
54,DISTRICT,JK_Ramban,Total,283713,149132,134581
57,DISTRICT,JK_Kishtwar,Total,230696,120165,110531
60,DISTRICT,JK_Udhampur,Total,554985,296784,258201
63,DISTRICT,JK_Reasi,Total,314667,166461,148206
66,DISTRICT,JK_Jammu,Total,1529958,813821,716137
69,DISTRICT,JK_Samba,Total,318898,169124,149774
72,STATE,HP,Total,6864602,3481873,3382729
75,DISTRICT,HP_Chamba,Total,519080,261320,257760
78,DISTRICT,HP_Kangra,Total,1510075,750591,759484
81,DISTRICT,HP_Lahaul and Spiti,Total,31564,16588,14976
84,DISTRICT,HP_Kullu,Total,437903,225452,212451
87,DISTRICT,HP_Mandi,Total,999777,498065,501712
90,DISTRICT,HP_Hamirpur,Total,454768,217070,237698
93,DISTRICT,HP_Una,Total,521173,263692,257481
96,DISTRICT,HP_Bilaspur,Total,381956,192764,189192
99,DISTRICT,HP_Solan,Total,580320,308754,271566
102,DISTRICT,HP_Sirmaur,Total,529855,276289,253566
105,DISTRICT,HP_Shimla,Total,814010,425039,388971
108,DISTRICT,HP_Kinnaur,Total,84121,46249,37872
111,STATE,PB,Total,27743338,14639465,13103873
114,DISTRICT,PB_Gurdaspur,Total,2298323,1212617,1085706
117,DISTRICT,PB_Kapurthala,Total,815168,426311,388857
120,DISTRICT,PB_Jalandhar,Total,2193590,1145211,1048379
123,DISTRICT,PB_Hoshiarpur,Total,1586625,809057,777568
126,DISTRICT,PB_Shahid Bhagat Singh Nagar,Total,612310,313291,299019
129,DISTRICT,PB_Fatehgarh Sahib,Total,600163,320795,279368
132,DISTRICT,PB_Ludhiana,Total,3498739,1867816,1630923
135,DISTRICT,PB_Moga,Total,995746,525920,469826
138,DISTRICT,PB_Ferozepur,Total,2029074,1071637,957437
141,DISTRICT,PB_Sri Muktsar Sahib,Total,901896,475622,426274
144,DISTRICT,PB_Faridkot,Total,617508,326671,290837
147,DISTRICT,PB_Bathinda,Total,1388525,743197,645328
150,DISTRICT,PB_Mansa,Total,769751,408732,361019
153,DISTRICT,PB_Patiala,Total,1895686,1002522,893164
156,DISTRICT,PB_Amritsar,Total,2490656,1318408,1172248
159,DISTRICT,PB_Tarn Taran,Total,1119627,589369,530258
162,DISTRICT,PB_Rupnagar,Total,684627,357485,327142
165,DISTRICT,PB_S.A.S. Nagar,Total,994628,529253,465375
168,DISTRICT,PB_Sangrur,Total,1655169,878029,777140
171,DISTRICT,PB_Barnala,Total,595527,317522,278005
174,STATE,CH,Total,1055450,580663,474787
177,DISTRICT,CH_Chandigarh,Total,1055450,580663,474787
180,STATE,UT,Total,10086292,5137773,4948519
183,DISTRICT,UT_Uttarkashi,Total,330086,168597,161489
186,DISTRICT,UT_Chamoli,Total,391605,193991,197614
189,DISTRICT,UT_Rudraprayag,Total,242285,114589,127696
192,DISTRICT,UT_Tehri Garhwal,Total,618931,297986,320945
195,DISTRICT,UT_Dehradun,Total,1696694,892199,804495
198,DISTRICT,UT_Pauri Garhwal,Total,687271,326829,360442
201,DISTRICT,UT_Pithoragarh,Total,483439,239306,244133
204,DISTRICT,UT_Bageshwar,Total,259898,124326,135572
207,DISTRICT,UT_Almora,Total,622506,291081,331425
210,DISTRICT,UT_Champawat,Total,259648,131125,128523
213,DISTRICT,UT_Nainital,Total,954605,493666,460939
216,DISTRICT,UT_Udham Singh Nagar,Total,1648902,858783,790119
219,DISTRICT,UT_Haridwar,Total,1890422,1005295,885127
222,STATE,HR,Total,25351462,13494734,11856728
225,DISTRICT,HR_Panchkula,Total,561293,299679,261614
228,DISTRICT,HR_Ambala,Total,1128350,598703,529647
231,DISTRICT,HR_Yamunanagar,Total,1214205,646718,567487
234,DISTRICT,HR_Kurukshetra,Total,964655,510976,453679
237,DISTRICT,HR_Kaithal,Total,1074304,571003,503301
240,DISTRICT,HR_Karnal,Total,1505324,797712,707612
243,DISTRICT,HR_Panipat,Total,1205437,646857,558580
246,DISTRICT,HR_Sonipat,Total,1450001,781299,668702
249,DISTRICT,HR_Jind,Total,1334152,713006,621146
252,DISTRICT,HR_Fatehabad,Total,942011,495360,446651
255,DISTRICT,HR_Sirsa,Total,1295189,682582,612607
258,DISTRICT,HR_Hisar,Total,1743931,931562,812369
261,DISTRICT,HR_Bhiwani,Total,1634445,866672,767773
264,DISTRICT,HR_Rohtak,Total,1061204,568479,492725
267,DISTRICT,HR_Jhajjar,Total,958405,514667,443738
270,DISTRICT,HR_Mahendragarh,Total,922088,486665,435423
273,DISTRICT,HR_Rewari,Total,900332,474335,425997
276,DISTRICT,HR_Gurugram,Total,1514432,816690,697742
279,DISTRICT,Mewat ,Total,1089263,571162,518101
282,DISTRICT,HR_Faridabad,Total,1809733,966110,843623
285,DISTRICT,HR_Palwal,Total,1042708,554497,488211
288,STATE,DL,Total,16787941,8987326,7800615
291,DISTRICT,DL_North West Delhi,Total,3656539,1960922,1695617
294,DISTRICT,DL_North Delhi,Total,887978,475002,412976
297,DISTRICT,DL_North East Delhi,Total,2241624,1188425,1053199
300,DISTRICT,DL_East Delhi,Total,1709346,907500,801846
303,DISTRICT,DL_New Delhi,Total,142004,77942,64062
306,DISTRICT,DL_Central Delhi,Total,582320,307821,274499
309,DISTRICT,DL_West Delhi,Total,2543243,1356240,1187003
312,DISTRICT,DL_South West Delhi,Total,2292958,1246046,1046912
315,DISTRICT,DL_South Delhi,Total,2731929,1467428,1264501
318,STATE,RJ,Total,68548437,35550997,32997440
321,DISTRICT,RJ_Ganganagar,Total,1969168,1043340,925828
324,DISTRICT,RJ_Hanumangarh,Total,1774692,931184,843508
327,DISTRICT,RJ_Bikaner,Total,2363937,1240801,1123136
330,DISTRICT,RJ_Churu,Total,2039547,1051446,988101
333,DISTRICT,RJ_Jhunjhunu,Total,2137045,1095896,1041149
336,DISTRICT,RJ_Alwar,Total,3674179,1939026,1735153
339,DISTRICT,RJ_Bharatpur,Total,2548462,1355726,1192736
342,DISTRICT,RJ_Dholpur,Total,1206516,653647,552869
345,DISTRICT,RJ_Karauli,Total,1458248,783639,674609
348,DISTRICT,RJ_Sawai Madhopur,Total,1335551,704031,631520
351,DISTRICT,RJ_Dausa,Total,1634409,857787,776622
354,DISTRICT,RJ_Jaipur,Total,6626178,3468507,3157671
357,DISTRICT,RJ_Sikar,Total,2677333,1374990,1302343
360,DISTRICT,RJ_Nagaur,Total,3307743,1696325,1611418
363,DISTRICT,RJ_Jodhpur,Total,3687165,1923928,1763237
366,DISTRICT,RJ_Jaisalmer,Total,669919,361708,308211
369,DISTRICT,RJ_Barmer,Total,2603751,1369022,1234729
372,DISTRICT,RJ_Jalore,Total,1828730,936634,892096
375,DISTRICT,RJ_Sirohi,Total,1036346,534231,502115
378,DISTRICT,RJ_Pali,Total,2037573,1025422,1012151
381,DISTRICT,RJ_Ajmer,Total,2583052,1324085,1258967
384,DISTRICT,RJ_Tonk,Total,1421326,728136,693190
387,DISTRICT,RJ_Bundi,Total,1110906,577160,533746
390,DISTRICT,RJ_Bhilwara,Total,2408523,1220736,1187787
393,DISTRICT,RJ_Rajsamand,Total,1156597,581339,575258
396,DISTRICT,RJ_Dungarpur,Total,1388552,696532,692020
399,DISTRICT,RJ_Banswara,Total,1797485,907754,889731
402,DISTRICT,RJ_Chittorgarh,Total,1544338,783171,761167
405,DISTRICT,RJ_Kota,Total,1951014,1021161,929853
408,DISTRICT,RJ_Baran,Total,1222755,633945,588810
411,DISTRICT,RJ_Jhalawar,Total,1411129,725143,685986
414,DISTRICT,RJ_Udaipur,Total,3068420,1566801,1501619
417,DISTRICT,RJ_Pratapgarh,Total,867848,437744,430104
420,STATE,UP,Total,199812341,104480510,95331831
423,DISTRICT,UP_Saharanpur,Total,3466382,1834106,1632276
426,DISTRICT,UP_Muzaffarnagar,Total,4143512,2193434,1950078
429,DISTRICT,UP_Bijnor,Total,3682713,1921215,1761498
432,DISTRICT,UP_Moradabad,Total,4772006,2503186,2268820
435,DISTRICT,UP_Rampur,Total,2335819,1223889,1111930
438,DISTRICT,UP_Amroha,Total,1840221,963449,876772
441,DISTRICT,UP_Meerut,Total,3443689,1825743,1617946
444,DISTRICT,UP_Baghpat,Total,1303048,700070,602978
447,DISTRICT,UP_Ghaziabad,Total,4681645,2488834,2192811
450,DISTRICT,UP_Gautam Buddha Nagar,Total,1648115,890214,757901
453,DISTRICT,UP_Bulandshahr,Total,3499171,1845260,1653911
456,DISTRICT,UP_Aligarh,Total,3673889,1951996,1721893
459,DISTRICT,UP_Hathras,Total,1564708,836127,728581
462,DISTRICT,UP_Mathura,Total,2547184,1367125,1180059
465,DISTRICT,UP_Agra,Total,4418797,2364953,2053844
468,DISTRICT,UP_Firozabad,Total,2498156,1332046,1166110
471,DISTRICT,UP_Mainpuri,Total,1868529,993377,875152
474,DISTRICT,UP_Budaun,Total,3681896,1967759,1714137
477,DISTRICT,UP_Bareilly,Total,4448359,2357665,2090694
480,DISTRICT,UP_Pilibhit,Total,2031007,1072002,959005
483,DISTRICT,UP_Shahjahanpur,Total,3006538,1606403,1400135
486,DISTRICT,UP_Lakhimpur Kheri,Total,4021243,2123187,1898056
489,DISTRICT,UP_Sitapur,Total,4483992,2375264,2108728
492,DISTRICT,UP_Hardoi,Total,4092845,2191442,1901403
495,DISTRICT,UP_Unnao,Total,3108367,1630087,1478280
498,DISTRICT,UP_Lucknow,Total,4589838,2394476,2195362
501,DISTRICT,UP_Rae Bareli,Total,3405559,1752542,1653017
504,DISTRICT,UP_Farrukhabad,Total,1885204,1006240,878964
507,DISTRICT,UP_Kannauj,Total,1656616,881776,774840
510,DISTRICT,UP_Etawah,Total,1581810,845856,735954
513,DISTRICT,UP_Auraiya,Total,1379545,740040,639505
516,DISTRICT,UP_Kanpur Dehat,Total,1796184,963255,832929
519,DISTRICT,UP_Kanpur Nagar,Total,4581268,2459806,2121462
522,DISTRICT,UP_Jalaun,Total,1689974,906092,783882
525,DISTRICT,UP_Jhansi,Total,1998603,1057436,941167
528,DISTRICT,UP_Lalitpur,Total,1221592,641011,580581
531,DISTRICT,UP_Hamirpur,Total,1104285,593537,510748
534,DISTRICT,UP_Mahoba,Total,875958,466358,409600
537,DISTRICT,UP_Banda,Total,1799410,965876,833534
540,DISTRICT,UP_Chitrakoot,Total,991730,527721,464009
543,DISTRICT,UP_Fatehpur,Total,2632733,1384722,1248011
546,DISTRICT,UP_Pratapgarh,Total,3209141,1606085,1603056
549,DISTRICT,UP_Kaushambi,Total,1599596,838485,761111
552,DISTRICT,UP_Prayagraj,Total,5954391,3131807,2822584
555,DISTRICT,UP_Barabanki,Total,3260699,1707073,1553626
558,DISTRICT,UP_Ayodhya,Total,2470996,1259628,1211368
561,DISTRICT,UP_Ambedkar Nagar,Total,2397888,1212410,1185478
564,DISTRICT,UP_Sultanpur,Total,3797117,1914586,1882531
567,DISTRICT,UP_Bahraich,Total,3487731,1843884,1643847
570,DISTRICT,UP_Shrawasti,Total,1117361,593897,523464
573,DISTRICT,UP_Balrampur,Total,2148665,1114721,1033944
576,DISTRICT,UP_Gonda,Total,3433919,1787146,1646773
579,DISTRICT,UP_Siddharthnagar,Total,2559297,1295095,1264202
582,DISTRICT,UP_Basti,Total,2464464,1255272,1209192
585,DISTRICT,UP_Sant Kabir Nagar,Total,1715183,869656,845527
588,DISTRICT,UP_Maharajganj,Total,2684703,1381754,1302949
591,DISTRICT,UP_Gorakhpur,Total,4440895,2277777,2163118
594,DISTRICT,UP_Kushinagar,Total,3564544,1818055,1746489
597,DISTRICT,UP_Deoria,Total,3100946,1537436,1563510
600,DISTRICT,UP_Azamgarh,Total,4613913,2285004,2328909
603,DISTRICT,UP_Mau,Total,2205968,1114709,1091259
606,DISTRICT,UP_Ballia,Total,3239774,1672902,1566872
609,DISTRICT,UP_Jaunpur,Total,4494204,2220465,2273739
612,DISTRICT,UP_Ghazipur,Total,3620268,1855075,1765193
615,DISTRICT,UP_Chandauli,Total,1952756,1017905,934851
618,DISTRICT,UP_Varanasi,Total,3676841,1921857,1754984
621,DISTRICT,UP_Bhadohi,Total,1578213,807099,771114
624,DISTRICT,UP_Mirzapur,Total,2496970,1312302,1184668
627,DISTRICT,UP_Sonbhadra,Total,1862559,971344,891215
630,DISTRICT,UP_Etah,Total,1774480,947339,827141
633,DISTRICT,Kanshiram Nagar,Total,1436719,764165,672554
636,STATE,BR,Total,104099452,54278157,49821295
639,DISTRICT,BR_West Champaran,Total,3935042,2061110,1873932
642,DISTRICT,BR_East Champaran,Total,5099371,2681209,2418162
645,DISTRICT,BR_Sheohar,Total,656246,346673,309573
648,DISTRICT,BR_Sitamarhi,Total,3423574,1803252,1620322
651,DISTRICT,BR_Madhubani,Total,4487379,2329313,2158066
654,DISTRICT,BR_Supaul,Total,2229076,1155283,1073793
657,DISTRICT,BR_Araria,Total,2811569,1463333,1348236
660,DISTRICT,BR_Kishanganj,Total,1690400,866970,823430
663,DISTRICT,BR_Purnia,Total,3264619,1699370,1565249
666,DISTRICT,BR_Katihar,Total,3071029,1600430,1470599
669,DISTRICT,BR_Madhepura,Total,2001762,1047559,954203
672,DISTRICT,BR_Saharsa,Total,1900661,997174,903487
675,DISTRICT,BR_Darbhanga,Total,3937385,2059949,1877436
678,DISTRICT,BR_Muzaffarpur,Total,4801062,2527497,2273565
681,DISTRICT,BR_Gopalganj,Total,2562012,1267666,1294346
684,DISTRICT,BR_Siwan,Total,3330464,1675090,1655374
687,DISTRICT,BR_Saran,Total,3951862,2022821,1929041
690,DISTRICT,BR_Vaishali,Total,3495021,1844535,1650486
693,DISTRICT,BR_Samastipur,Total,4261566,2230003,2031563
696,DISTRICT,BR_Begusarai,Total,2970541,1567660,1402881
699,DISTRICT,BR_Khagaria,Total,1666886,883786,783100
702,DISTRICT,BR_Bhagalpur,Total,3037766,1615663,1422103
705,DISTRICT,BR_Banka,Total,2034763,1067140,967623
708,DISTRICT,BR_Munger,Total,1367765,729041,638724
711,DISTRICT,BR_Lakhisarai,Total,1000912,526345,474567
714,DISTRICT,BR_Sheikhpura,Total,636342,329743,306599
717,DISTRICT,BR_Nalanda,Total,2877653,1497060,1380593
720,DISTRICT,BR_Patna,Total,5838465,3078512,2759953
723,DISTRICT,BR_Bhojpur,Total,2728407,1430380,1298027
726,DISTRICT,BR_Buxar,Total,1706352,887977,818375
729,DISTRICT,BR_Kaimur,Total,1626384,847006,779378
732,DISTRICT,BR_Rohtas,Total,2959918,1543546,1416372
735,DISTRICT,BR_Aurangabad,Total,2540073,1318684,1221389
738,DISTRICT,BR_Gaya,Total,4391418,2266566,2124852
741,DISTRICT,BR_Nawada,Total,2219146,1144668,1074478
744,DISTRICT,BR_Jamui,Total,1760405,916064,844341
747,DISTRICT,BR_Jehanabad,Total,1125313,585582,539731
750,DISTRICT,BR_Arwal,Total,700843,363497,337346
753,STATE,SK,Total,610577,323070,287507
756,DISTRICT,SK_North Sikkkim,Total,43709,24730,18979
759,DISTRICT,SK_West Sikkim,Total,136435,70238,66197
762,DISTRICT,SK_South Sikkim,Total,146850,76670,70180
765,DISTRICT,SK_East Sikkim,Total,283583,151432,132151
768,STATE,AR,Total,1383727,713912,669815
771,DISTRICT,AR_Tawang,Total,49977,29151,20826
774,DISTRICT,AR_West Kameng,Total,83947,46155,37792
777,DISTRICT,AR_East Kameng,Total,78690,38775,39915
780,DISTRICT,AR_Papum Pare,Total,176573,89182,87391
783,DISTRICT,AR_Upper Subansiri,Total,83448,41758,41690
786,DISTRICT,AR_West Siang,Total,112274,58168,54106
789,DISTRICT,AR_East Siang,Total,99214,50116,49098
792,DISTRICT,AR_Upper Siang,Total,35320,18699,16621
795,DISTRICT,AR_Changlang,Total,148226,76948,71278
798,DISTRICT,AR_Tirap,Total,111975,57604,54371
801,DISTRICT,AR_Lower Subansiri,Total,83030,41843,41187
804,DISTRICT,AR_Kurung Kumey,Total,92076,45318,46758
807,DISTRICT,AR_Upper Dibang Valley,Total,8004,4414,3590
810,DISTRICT,AR_Lower Dibang Valley,Total,54080,28053,26027
813,DISTRICT,AR_Lohit,Total,145726,76221,69505
816,DISTRICT,AR_Anjaw,Total,21167,11507,9660
819,STATE,NL,Total,1978502,1024649,953853
822,DISTRICT,NL_Mon,Total,250260,131753,118507
825,DISTRICT,NL_Mokokchung,Total,194622,101092,93530
828,DISTRICT,NL_Zunheboto,Total,140757,71217,69540
831,DISTRICT,NL_Wokha,Total,166343,84505,81838
834,DISTRICT,NL_Dimapur,Total,378811,197394,181417
837,DISTRICT,NL_Phek,Total,163418,83743,79675
840,DISTRICT,NL_Tuensang,Total,196596,101933,94663
843,DISTRICT,NL_Longleng,Total,50484,26502,23982
846,DISTRICT,NL_Kiphire,Total,74004,37830,36174
849,DISTRICT,NL_Kohima,Total,267988,138966,129022
852,DISTRICT,NL_Peren,Total,95219,49714,45505
855,STATE,MN,Total,2855794,1438586,1417208
858,DISTRICT,MN_Senapati,Total,479148,247323,231825
861,DISTRICT,MN_Tamenglong,Total,140651,72371,68280
864,DISTRICT,MN_Churachandpur,Total,274143,138820,135323
867,DISTRICT,MN_Bishnupur,Total,237399,118782,118617
870,DISTRICT,MN_Thoubal,Total,422168,210845,211323
873,DISTRICT,MN_Imphal West,Total,517992,255054,262938
876,DISTRICT,MN_Imphal East,Total,456113,226094,230019
879,DISTRICT,MN_Ukhrul,Total,183998,94718,89280
882,DISTRICT,MN_Chandel,Total,144182,74579,69603
885,STATE,MZ,Total,1097206,555339,541867
888,DISTRICT,MZ_Mamit,Total,86364,44828,41536
891,DISTRICT,MZ_Kolasib,Total,83955,42918,41037
894,DISTRICT,MZ_Aizawl,Total,400309,199270,201039
897,DISTRICT,MZ_Champhai,Total,125745,63388,62357
900,DISTRICT,MZ_Serchhip,Total,64937,32851,32086
903,DISTRICT,MZ_Lunglei,Total,161428,82891,78537
906,DISTRICT,MZ_Lawngtlai,Total,117894,60599,57295
909,DISTRICT,MZ_Saiha,Total,56574,28594,27980
912,STATE,TR,Total,3673917,1874376,1799541
915,DISTRICT,TR_West Tripura,Total,1725739,879428,846311
918,DISTRICT,TR_South Tripura,Total,876001,447544,428457
921,DISTRICT,TR_Dhalai,Total,378230,194544,183686
924,DISTRICT,TR_North Tripura,Total,693947,352860,341087
927,STATE,ML,Total,2966889,1491832,1475057
930,DISTRICT,ML_West Garo Hills,Total,643291,324159,319132
933,DISTRICT,ML_East Garo Hills,Total,317917,161223,156694
936,DISTRICT,ML_South Garo Hills,Total,142334,73170,69164
939,DISTRICT,ML_West Khasi Hills,Total,383461,193715,189746
942,DISTRICT,ML_Ribhoi,Total,258840,132531,126309
945,DISTRICT,ML_East Khasi Hills,Total,825922,410749,415173
948,DISTRICT,ML_West Jaintia Hills,Total,395124,196285,198839
951,STATE,AS,Total,31205576,15939443,15266133
954,DISTRICT,AS_Kokrajhar,Total,887142,452905,434237
957,DISTRICT,AS_Dhubri,Total,1949258,997848,951410
960,DISTRICT,AS_Goalpara,Total,1008183,513292,494891
963,DISTRICT,AS_Barpeta,Total,1693622,867004,826618
966,DISTRICT,AS_Morigaon,Total,957423,486651,470772
969,DISTRICT,AS_Nagaon,Total,2823768,1439112,1384656
972,DISTRICT,AS_Sonitpur,Total,1924110,983904,940206
975,DISTRICT,AS_Lakhimpur,Total,1042137,529674,512463
978,DISTRICT,AS_Dhemaji,Total,686133,351249,334884
981,DISTRICT,AS_Tinsukia,Total,1327929,680231,647698
984,DISTRICT,AS_Dibrugarh,Total,1326335,676434,649901
987,DISTRICT,AS_Sivasagar,Total,1151050,589216,561834
990,DISTRICT,AS_Jorhat,Total,1092256,556805,535451
993,DISTRICT,AS_Golaghat,Total,1066888,543161,523727
996,DISTRICT,AS_Karbi Anglong,Total,956313,490167,466146
999,DISTRICT,AS_Dima Hasao,Total,214102,110802,103300
1002,DISTRICT,AS_Cachar,Total,1736617,886284,850333
1005,DISTRICT,AS_Karimganj,Total,1228686,625864,602822
1008,DISTRICT,AS_Hailakandi,Total,659296,337890,321406
1011,DISTRICT,AS_Bongaigaon,Total,738804,375818,362986
1014,DISTRICT,AS_Chirang,Total,482162,244860,237302
1017,DISTRICT,AS_Kamrup,Total,1517542,778461,739081
1020,DISTRICT,AS_Kamrup Metropolitan,Total,1253938,647585,606353
1023,DISTRICT,AS_Nalbari,Total,771639,396006,375633
1026,DISTRICT,AS_Baksa,Total,950075,481330,468745
1029,DISTRICT,AS_Darrang,Total,928500,475273,453227
1032,DISTRICT,AS_Udalguri,Total,831668,421617,410051
1035,STATE,WB,Total,91276115,46809027,44467088
1038,DISTRICT,WB_Darjeeling,Total,1846823,937259,909564
1041,DISTRICT,WB_Jalpaiguri,Total,3872846,1983064,1889782
1044,DISTRICT,Koch Bihar ,Total,2819086,1451542,1367544
1047,DISTRICT,WB_Uttar Dinajpur,Total,3007134,1551066,1456068
1050,DISTRICT,WB_Dakshin Dinajpur,Total,1676276,857199,819077
1053,DISTRICT,WB_Malda,Total,3988845,2051541,1937304
1056,DISTRICT,WB_Murshidabad,Total,7103807,3627564,3476243
1059,DISTRICT,WB_Birbhum,Total,3502404,1790920,1711484
1062,DISTRICT,WB_Purba Bardhaman,Total,7717563,3966889,3750674
1065,DISTRICT,WB_Nadia,Total,5167600,2653768,2513832
1068,DISTRICT,WB_North 24 Parganas,Total,10009781,5119389,4890392
1071,DISTRICT,Hugli ,Total,5519145,2814653,2704492
1074,DISTRICT,WB_Bankura,Total,3596674,1838095,1758579
1077,DISTRICT,WB_Purulia,Total,2930115,1496996,1433119
1080,DISTRICT,Haora ,Total,4850029,2500819,2349210
1083,DISTRICT,WB_Kolkata,Total,4496694,2356766,2139928
1086,DISTRICT,WB_South 24 Parganas,Total,8161961,4173778,3988183
1089,DISTRICT,WB_Paschim Medinipur,Total,5913457,3007885,2905572
1092,DISTRICT,WB_Purba Medinipur,Total,5095875,2629834,2466041
1095,STATE,JH,Total,32988134,16930315,16057819
1098,DISTRICT,JH_Garhwa,Total,1322784,683575,639209
1101,DISTRICT,JH_Chatra,Total,1042886,533935,508951
1104,DISTRICT,JH_Koderma,Total,716259,367222,349037
1107,DISTRICT,JH_Giridih,Total,2445474,1258098,1187376
1110,DISTRICT,JH_Deoghar,Total,1492073,775022,717051
1113,DISTRICT,JH_Godda,Total,1313551,677927,635624
1116,DISTRICT,JH_Sahibganj,Total,1150567,589391,561176
1119,DISTRICT,JH_Pakur,Total,900422,452661,447761
1122,DISTRICT,JH_Dhanbad,Total,2684487,1405956,1278531
1125,DISTRICT,JH_Bokaro,Total,2062330,1072807,989523
1128,DISTRICT,JH_Lohardaga,Total,461790,232629,229161
1131,DISTRICT,JH_East Singhbhum,Total,2293919,1176902,1117017
1134,DISTRICT,JH_Palamu,Total,1939869,1006302,933567
1137,DISTRICT,JH_Latehar,Total,726978,369666,357312
1140,DISTRICT,JH_Hazaribagh,Total,1734495,890881,843614
1143,DISTRICT,JH_Ramgarh,Total,949443,494230,455213
1146,DISTRICT,JH_Dumka,Total,1321442,668514,652928
1149,DISTRICT,JH_Jamtara,Total,791042,404830,386212
1152,DISTRICT,JH_Ranchi,Total,2914253,1494937,1419316
1155,DISTRICT,JH_Khunti,Total,531885,266335,265550
1158,DISTRICT,JH_Gumla,Total,1025213,514390,510823
1161,DISTRICT,JH_Simdega,Total,599578,300309,299269
1164,DISTRICT,JH_West Singhbhum,Total,1502338,749385,752953
1167,DISTRICT,Saraikela-Kharsawan,Total,1065056,544411,520645
1170,STATE,OR,Total,41974218,21212136,20762082
1173,DISTRICT,OR_Bargarh,Total,1481255,749161,732094
1176,DISTRICT,OR_Jharsuguda,Total,579505,296690,282815
1179,DISTRICT,OR_Sambalpur,Total,1041099,526877,514222
1182,DISTRICT,OR_Deogarh,Total,312520,158230,154290
1185,DISTRICT,OR_Sundargarh,Total,2093437,1061147,1032290
1188,DISTRICT,OR_Kendujhar,Total,1801733,906487,895246
1191,DISTRICT,OR_Mayurbhanj,Total,2519738,1256213,1263525
1194,DISTRICT,OR_Balasore,Total,2320529,1185787,1134742
1197,DISTRICT,OR_Bhadrak,Total,1506337,760260,746077
1200,DISTRICT,OR_Kendrapara,Total,1440361,717814,722547
1203,DISTRICT,OR_Jagatsinghpur,Total,1136971,577865,559106
1206,DISTRICT,OR_Cuttack,Total,2624470,1352760,1271710
1209,DISTRICT,OR_Jajpur,Total,1827192,926034,901158
1212,DISTRICT,OR_Dhenkanal,Total,1192811,612593,580218
1215,DISTRICT,OR_Angul,Total,1273821,655718,618103
1218,DISTRICT,OR_Nayagarh,Total,962789,502636,460153
1221,DISTRICT,OR_Khordha,Total,2251673,1167137,1084536
1224,DISTRICT,OR_Puri,Total,1698730,865380,833350
1227,DISTRICT,OR_Ganjam,Total,3529031,1779218,1749813
1230,DISTRICT,OR_Gajapati,Total,577817,282882,294935
1233,DISTRICT,OR_Kandhamal,Total,733110,359945,373165
1236,DISTRICT,OR_Boudh,Total,441162,221625,219537
1239,DISTRICT,OR_Subarnapur,Total,610183,311312,298871
1242,DISTRICT,OR_Balangir,Total,1648997,830097,818900
1245,DISTRICT,OR_Nuapada,Total,610382,301962,308420
1248,DISTRICT,OR_Kalahandi,Total,1576869,787101,789768
1251,DISTRICT,OR_Rayagada,Total,967911,471960,495951
1254,DISTRICT,OR_Nabarangapur,Total,1220946,604812,616134
1257,DISTRICT,OR_Koraput,Total,1379647,678809,700838
1260,DISTRICT,OR_Malkangiri,Total,613192,303624,309568
1263,STATE,CT,Total,25545198,12832895,12712303
1266,DISTRICT,CT_Koriya,Total,658917,334737,324180
1269,DISTRICT,CT_Surguja,Total,2359886,1193129,1166757
1272,DISTRICT,CT_Jashpur,Total,851669,424747,426922
1275,DISTRICT,CT_Raigarh,Total,1493984,750278,743706
1278,DISTRICT,CT_Korba,Total,1206640,612915,593725
1281,DISTRICT,CT_Janjgir Champa,Total,1619707,815717,803990
1284,DISTRICT,CT_Bilaspur,Total,2663629,1351574,1312055
1287,DISTRICT,CT_Kabeerdham,Total,822526,412058,410468
1290,DISTRICT,CT_Rajnandgaon,Total,1537133,762855,774278
1293,DISTRICT,CT_Durg,Total,3343872,1682101,1661771
1296,DISTRICT,CT_Raipur,Total,4063872,2048186,2015686
1299,DISTRICT,CT_Mahasamund,Total,1032754,511967,520787
1302,DISTRICT,CT_Dhamtari,Total,799781,397897,401884
1305,DISTRICT,CT_Uttar Bastar Kanker,Total,748941,373338,375603
1308,DISTRICT,CT_Bastar,Total,1413199,698487,714712
1311,DISTRICT,CT_Narayanpur,Total,139820,70104,69716
1314,DISTRICT,CT_Dakshin Bastar Dantewada,Total,533638,264142,269496
1317,DISTRICT,CT_Bijapur,Total,255230,128663,126567
1320,STATE,MP,Total,72626809,37612306,35014503
1323,DISTRICT,MP_Sheopur,Total,687861,361784,326077
1326,DISTRICT,MP_Morena,Total,1965970,1068417,897553
1329,DISTRICT,MP_Bhind,Total,1703005,926843,776162
1332,DISTRICT,MP_Gwalior,Total,2032036,1090327,941709
1335,DISTRICT,MP_Datia,Total,786754,420157,366597
1338,DISTRICT,MP_Shivpuri,Total,1726050,919795,806255
1341,DISTRICT,MP_Tikamgarh,Total,1445166,760355,684811
1344,DISTRICT,MP_Chhatarpur,Total,1762375,936121,826254
1347,DISTRICT,MP_Panna,Total,1016520,533480,483040
1350,DISTRICT,MP_Sagar,Total,2378458,1256257,1122201
1353,DISTRICT,MP_Damoh,Total,1264219,661873,602346
1356,DISTRICT,MP_Satna,Total,2228935,1157495,1071440
1359,DISTRICT,MP_Rewa,Total,2365106,1225100,1140006
1362,DISTRICT,MP_Umaria,Total,644758,330674,314084
1365,DISTRICT,MP_Neemuch,Total,826067,422653,403414
1368,DISTRICT,MP_Mandsaur,Total,1340411,682851,657560
1371,DISTRICT,MP_Ratlam,Total,1455069,738241,716828
1374,DISTRICT,MP_Ujjain,Total,1986864,1016289,970575
1377,DISTRICT,MP_Shajapur,Total,1512681,780520,732161
1380,DISTRICT,MP_Dewas,Total,1563715,805359,758356
1383,DISTRICT,MP_Dhar,Total,2185793,1112725,1073068
1386,DISTRICT,MP_Indore,Total,3276697,1699627,1577070
1389,DISTRICT,MP_Khargone,Total,1873046,953121,919925
1392,DISTRICT,MP_Barwani,Total,1385881,699340,686541
1395,DISTRICT,MP_Rajgarh,Total,1545814,790212,755602
1398,DISTRICT,MP_Vidisha,Total,1458875,769568,689307
1401,DISTRICT,MP_Bhopal,Total,2371061,1236130,1134931
1404,DISTRICT,MP_Sehore,Total,1311332,683743,627589
1407,DISTRICT,MP_Raisen,Total,1331597,700358,631239
1410,DISTRICT,MP_Betul,Total,1575362,799236,776126
1413,DISTRICT,MP_Harda,Total,570465,294838,275627
1416,DISTRICT,MP_Hoshangabad,Total,1241350,648725,592625
1419,DISTRICT,MP_Katni,Total,1292042,662013,630029
1422,DISTRICT,MP_Jabalpur,Total,2463289,1277278,1186011
1425,DISTRICT,MP_Narsinghpur,Total,1091854,568810,523044
1428,DISTRICT,MP_Dindori,Total,704524,351913,352611
1431,DISTRICT,MP_Mandla,Total,1054905,525272,529633
1434,DISTRICT,MP_Chhindwara,Total,2090922,1064468,1026454
1437,DISTRICT,MP_Seoni,Total,1379131,695879,683252
1440,DISTRICT,MP_Balaghat,Total,1701698,842178,859520
1443,DISTRICT,MP_Guna,Total,1241519,649362,592157
1446,DISTRICT,MP_Ashoknagar,Total,845071,443837,401234
1449,DISTRICT,MP_Shahdol,Total,1066063,540021,526042
1452,DISTRICT,MP_Anuppur,Total,749237,379114,370123
1455,DISTRICT,MP_Sidhi,Total,1127033,575912,551121
1458,DISTRICT,MP_Singrauli,Total,1178273,613637,564636
1461,DISTRICT,MP_Jhabua,Total,1025048,515023,510025
1464,DISTRICT,MP_Alirajpur,Total,728999,362542,366457
1467,DISTRICT,MP_Khandwa,Total,1310061,674329,635732
1470,DISTRICT,MP_Burhanpur,Total,757847,388504,369343
1473,STATE,GJ,Total,60439692,31491260,28948432
1476,DISTRICT,Kachchh,Total,2092371,1096737,995634
1479,DISTRICT,GJ_Banaskantha,Total,3120506,1610379,1510127
1482,DISTRICT,GJ_Patan,Total,1343734,694397,649337
1485,DISTRICT,GJ_Mehsana,Total,2035064,1056520,978544
1488,DISTRICT,GJ_Sabarkantha,Total,2428589,1244231,1184358
1491,DISTRICT,GJ_Gandhinagar,Total,1391753,723864,667889
1494,DISTRICT,GJ_Ahmedabad,Total,7214225,3788051,3426174
1497,DISTRICT,GJ_Surendranagar,Total,1756268,909917,846351
1500,DISTRICT,GJ_Rajkot,Total,3804558,1974445,1830113
1503,DISTRICT,GJ_Jamnagar,Total,2160119,1114192,1045927
1506,DISTRICT,GJ_Porbandar,Total,585449,300209,285240
1509,DISTRICT,GJ_Junagadh,Total,2743082,1404356,1338726
1512,DISTRICT,GJ_Amreli,Total,1514190,771049,743141
1515,DISTRICT,GJ_Bhavnagar,Total,2880365,1490201,1390164
1518,DISTRICT,GJ_Anand,Total,2092745,1087224,1005521
1521,DISTRICT,GJ_Kheda,Total,2299885,1185727,1114158
1524,DISTRICT,GJ_Panchmahal,Total,2390776,1226961,1163815
1527,DISTRICT,Dohad,Total,2127086,1068651,1058435
1530,DISTRICT,GJ_Vadodara,Total,4165626,2153736,2011890
1533,DISTRICT,GJ_Narmada,Total,590297,301086,289211
1536,DISTRICT,GJ_Bharuch,Total,1551019,805707,745312
1539,DISTRICT,GJ_Dang,Total,228291,113821,114470
1542,DISTRICT,GJ_Navsari,Total,1329672,678165,651507
1545,DISTRICT,GJ_Valsad,Total,1705678,887222,818456
1548,DISTRICT,GJ_Surat,Total,6081322,3402224,2679098
1551,DISTRICT,GJ_Tapi,Total,807022,402188,404834
1554,STATE,DAMAN AND DIU,Total,243247,150301,92946
1557,DISTRICT,DN_Diu,Total,52074,25642,26432
1560,DISTRICT,DN_Daman,Total,191173,124659,66514
1563,STATE,DN,Total,343709,193760,149949
1566,DISTRICT,DN_Dadra and Nagar Haveli,Total,343709,193760,149949
1569,STATE,MH,Total,112374333,58243056,54131277
1572,DISTRICT,MH_Nandurbar,Total,1648295,833170,815125
1575,DISTRICT,MH_Dhule,Total,2050862,1054031,996831
1578,DISTRICT,MH_Jalgaon,Total,4229917,2197365,2032552
1581,DISTRICT,MH_Buldhana,Total,2586258,1337560,1248698
1584,DISTRICT,MH_Akola,Total,1813906,932334,881572
1587,DISTRICT,MH_Washim,Total,1197160,620302,576858
1590,DISTRICT,MH_Amravati,Total,2888445,1480768,1407677
1593,DISTRICT,MH_Wardha,Total,1300774,668385,632389
1596,DISTRICT,MH_Nagpur,Total,4653570,2384975,2268595
1599,DISTRICT,MH_Bhandara,Total,1200334,605520,594814
1602,DISTRICT,MH_Gondia,Total,1322507,661554,660953
1605,DISTRICT,MH_Gadchiroli,Total,1072942,541328,531614
1608,DISTRICT,MH_Chandrapur,Total,2204307,1123834,1080473
1611,DISTRICT,MH_Yavatmal,Total,2772348,1419965,1352383
1614,DISTRICT,MH_Nanded,Total,3361292,1730075,1631217
1617,DISTRICT,MH_Hingoli,Total,1177345,606294,571051
1620,DISTRICT,MH_Parbhani,Total,1836086,942870,893216
1623,DISTRICT,MH_Jalna,Total,1959046,1011473,947573
1626,DISTRICT,MH_Aurangabad,Total,3701282,1924469,1776813
1629,DISTRICT,MH_Nashik,Total,6107187,3157186,2950001
1632,DISTRICT,MH_Thane,Total,11060148,5865078,5195070
1635,DISTRICT,MH_Mumbai,Total,9356962,5031323,4325639
1638,DISTRICT,Mubai,Total,3085411,1684608,1400803
1641,DISTRICT,MH_Raigad,Total,2634200,1344345,1289855
1644,DISTRICT,MH_Pune,Total,9429408,4924105,4505303
1647,DISTRICT,MH_Ahmednagar,Total,4543159,2342825,2200334
1650,DISTRICT,MH_Beed,Total,2585049,1349106,1235943
1653,DISTRICT,MH_Latur,Total,2454196,1273140,1181056
1656,DISTRICT,MH_Osmanabad,Total,1657576,861535,796041
1659,DISTRICT,MH_Solapur,Total,4317756,2227852,2089904
1662,DISTRICT,MH_Satara,Total,3003741,1510842,1492899
1665,DISTRICT,MH_Ratnagiri,Total,1615069,761121,853948
1668,DISTRICT,MH_Sindhudurg,Total,849651,417332,432319
1671,DISTRICT,MH_Kolhapur,Total,3876001,1980658,1895343
1674,DISTRICT,MH_Sangli,Total,2822143,1435728,1386415
1677,STATE,AP,Total,84580777,42442146,42138631
1680,DISTRICT,TG_Adilabad,Total,2741239,1369597,1371642
1683,DISTRICT,TG_Nizamabad,Total,2551335,1250641,1300694
1686,DISTRICT,TG_Karimnagar,Total,3776269,1880800,1895469
1689,DISTRICT,TG_Medak,Total,3033288,1523030,1510258
1692,DISTRICT,TG_Hyderabad,Total,3943323,2018575,1924748
1695,DISTRICT,TG_Ranga Reddy,Total,5296741,2701008,2595733
1698,DISTRICT,TG_Mahabubnagar,Total,4053028,2050386,2002642
1701,DISTRICT,TG_Nalgonda,Total,3488809,1759772,1729037
1704,DISTRICT,TG_Warangal Urban,Total,3512576,1759281,1753295
1707,DISTRICT,TG_Khammam,Total,2797370,1390988,1406382
1710,DISTRICT,AP_Srikakulam,Total,2703114,1341738,1361376
1713,DISTRICT,AP_Vizianagaram,Total,2344474,1161477,1182997
1716,DISTRICT,AP_Visakhapatnam,Total,4290589,2138910,2151679
1719,DISTRICT,AP_East Godavari,Total,5154296,2569688,2584608
1722,DISTRICT,AP_West Godavari,Total,3936966,1964918,1972048
1725,DISTRICT,AP_Krishna,Total,4517398,2267375,2250023
1728,DISTRICT,AP_Guntur,Total,4887813,2440521,2447292
1731,DISTRICT,AP_Prakasam,Total,3397448,1714764,1682684
1734,DISTRICT,AP_S.P.S. Nellore,Total,2963557,1492974,1470583
1737,DISTRICT,AP_Y.S.R. Kadapa,Total,2882469,1451777,1430692
1740,DISTRICT,AP_Kurnool,Total,4053463,2039227,2014236
1743,DISTRICT,AP_Anantapur,Total,4081148,2064495,2016653
1746,DISTRICT,AP_Chittoor,Total,4174064,2090204,2083860
1749,STATE,KA,Total,61095297,30966657,30128640
1752,DISTRICT,KA_Belagavi,Total,4779661,2423063,2356598
1755,DISTRICT,KA_Bagalkote,Total,1889752,950111,939641
1758,DISTRICT,KA_Vijayapura,Total,2177331,1111022,1066309
1761,DISTRICT,KA_Bidar,Total,1703300,870665,832635
1764,DISTRICT,KA_Raichur,Total,1928812,964511,964301
1767,DISTRICT,KA_Koppal,Total,1389920,699926,689994
1770,DISTRICT,KA_Gadag,Total,1064570,537147,527423
1773,DISTRICT,KA_Dharwad,Total,1847023,937206,909817
1776,DISTRICT,KA_Uttara Kannada,Total,1437169,726256,710913
1779,DISTRICT,KA_Haveri,Total,1597668,819128,778540
1782,DISTRICT,KA_Ballari,Total,2452595,1236954,1215641
1785,DISTRICT,KA_Chitradurga,Total,1659456,840843,818613
1788,DISTRICT,KA_Davanagere,Total,1945497,986400,959097
1791,DISTRICT,KA_Shivamogga,Total,1752753,877415,875338
1794,DISTRICT,KA_Udupi,Total,1177361,562131,615230
1797,DISTRICT,KA_Chikkamagaluru,Total,1137961,566622,571339
1800,DISTRICT,KA_Tumakuru,Total,2678980,1350594,1328386
1803,DISTRICT,Bangalore,Total,9621551,5022661,4598890
1806,DISTRICT,KA_Mandya,Total,1805769,905085,900684
1809,DISTRICT,KA_Hassan,Total,1776421,883667,892754
1812,DISTRICT,KA_Dakshina Kannada,Total,2089649,1034714,1054935
1815,DISTRICT,KA_Kodagu,Total,554519,274608,279911
1818,DISTRICT,KA_Mysuru,Total,3001127,1511600,1489527
1821,DISTRICT,KA_Chamarajanagara,Total,1020791,512231,508560
1824,DISTRICT,KA_Kalaburagi,Total,2566326,1301755,1264571
1827,DISTRICT,KA_Yadgir,Total,1174271,590329,583942
1830,DISTRICT,KA_Kolar,Total,1536401,776396,760005
1833,DISTRICT,KA_Chikkaballapura,Total,1255104,636437,618667
1836,DISTRICT,KA_Bengaluru Rural,Total,990923,509172,481751
1839,DISTRICT,KA_Ramanagara,Total,1082636,548008,534628
1842,STATE,GA,Total,1458545,739140,719405
1845,DISTRICT,GA_North Goa,Total,818008,416677,401331
1848,DISTRICT,GA_South Goa,Total,640537,322463,318074
1851,STATE,LD,Total,64473,33123,31350
1854,DISTRICT,LD_Lakshadweep,Total,64473,33123,31350
1857,STATE,KL,Total,33406061,16027412,17378649
1860,DISTRICT,KL_Kasaragod,Total,1307375,628613,678762
1863,DISTRICT,KL_Kannur,Total,2523003,1181446,1341557
1866,DISTRICT,KL_Wayanad,Total,817420,401684,415736
1869,DISTRICT,KL_Kozhikode,Total,3086293,1470942,1615351
1872,DISTRICT,KL_Malappuram,Total,4112920,1960328,2152592
1875,DISTRICT,KL_Palakkad,Total,2809934,1359478,1450456
1878,DISTRICT,KL_Thrissur,Total,3121200,1480763,1640437
1881,DISTRICT,KL_Ernakulam,Total,3282388,1619557,1662831
1884,DISTRICT,KL_Idukki,Total,1108974,552808,556166
1887,DISTRICT,KL_Kottayam,Total,1974551,968289,1006262
1890,DISTRICT,KL_Alappuzha,Total,2127789,1013142,1114647
1893,DISTRICT,KL_Pathanamthitta,Total,1197412,561716,635696
1896,DISTRICT,KL_Kollam,Total,2635375,1246968,1388407
1899,DISTRICT,KL_Thiruvananthapuram,Total,3301427,1581678,1719749
1902,STATE,TN,Total,72147030,36137975,36009055
1905,DISTRICT,TN_Thiruvallur,Total,3728104,1876062,1852042
1908,DISTRICT,TN_Chennai,Total,4646732,2335844,2310888
1911,DISTRICT,TN_Kancheepuram,Total,3998252,2012958,1985294
1914,DISTRICT,TN_Vellore,Total,3936331,1961688,1974643
1917,DISTRICT,TN_Tiruvannamalai,Total,2464875,1235889,1228986
1920,DISTRICT,TN_Viluppuram,Total,3458873,1740819,1718054
1923,DISTRICT,TN_Salem,Total,3482056,1781571,1700485
1926,DISTRICT,TN_Namakkal,Total,1726601,869280,857321
1929,DISTRICT,TN_Erode,Total,2251744,1129868,1121876
1932,DISTRICT,TN_Nilgiris,Total,735394,360143,375251
1935,DISTRICT,TN_Dindigul,Total,2159775,1080938,1078837
1938,DISTRICT,TN_Karur,Total,1064493,528184,536309
1941,DISTRICT,TN_Tiruchirappalli,Total,2722290,1352284,1370006
1944,DISTRICT,TN_Perambalur,Total,565223,282157,283066
1947,DISTRICT,TN_Ariyalur,Total,754894,374703,380191
1950,DISTRICT,TN_Cuddalore,Total,2605914,1311697,1294217
1953,DISTRICT,TN_Nagapattinam,Total,1616450,798127,818323
1956,DISTRICT,TN_Thiruvarur,Total,1264277,626693,637584
1959,DISTRICT,TN_Thanjavur,Total,2405890,1182416,1223474
1962,DISTRICT,TN_Pudukkottai,Total,1618345,803188,815157
1965,DISTRICT,TN_Sivaganga,Total,1339101,668672,670429
1968,DISTRICT,TN_Madurai,Total,3038252,1526475,1511777
1971,DISTRICT,TN_Theni,Total,1245899,625683,620216
1974,DISTRICT,TN_Virudhunagar,Total,1942288,967709,974579
1977,DISTRICT,TN_Ramanathapuram,Total,1353445,682658,670787
1980,DISTRICT,TN_Thoothukkudi,Total,1750176,865021,885155
1983,DISTRICT,TN_Tirunelveli,Total,3077233,1520912,1556321
1986,DISTRICT,TN_Kanyakumari,Total,1870374,926345,944029
1989,DISTRICT,TN_Dharmapuri,Total,1506843,774303,732540
1992,DISTRICT,TN_Krishnagiri,Total,1879809,960232,919577
1995,DISTRICT,TN_Coimbatore,Total,3458045,1729297,1728748
1998,DISTRICT,TN_Tiruppur,Total,2479052,1246159,1232893
2001,STATE,PY,Total,1247953,612511,635442
2004,DISTRICT,Yanam,Total,55626,27301,28325
2007,DISTRICT,PY_Puducherry,Total,950289,468258,482031
2010,DISTRICT,PY_Mahe,Total,41816,19143,22673
2013,DISTRICT,PY_Karaikal,Total,200222,97809,102413
2016,STATE,ANDAMAN AND NICOBAR ISLANDS,Total,380581,202871,177710
2019,DISTRICT,Nicobars,Total,36842,20727,16115
2022,DISTRICT,NorthAND Middle Andaman,Total,105597,54861,50736
2025,DISTRICT,South Andaman,Total,238142,127283,110859
